###################################
# # ### ######### # # # ### # # # #
# # #   #           #   #         #
# # # ### ######### ##### ### ### #
# # # # #   #     #   #     # # # #
### # # ### # # ### # # # ### # ###
#S            #   # # # # #   #   #
#   #         #   #   #     # # ###
# # ### ######### # # # ### # # # #
# # #   #           #   #         #
# # # ### ######### ##### ### ### #
# # # # #   #     #   #     # # # #
### # # ### # # ### # # # ### # ###
#      #   # # # # #   #   ########
#   #         #   #   #     # # # #
# # ### ######### # # # ### # # # #
# # #   #           #   #         #
# # # ### ######### ##### ### ### #
# # # # #   #     #   #     # # # #
### # # ### # # ### # # # ### # ###
#             #   # # # # #   #   #
#   #         #   #   #     # # # #
# # ### ######### # # # ### # # # #
# # #   #           #   #         #
# # # ### ######### ##### ### ### #
# # # # #   #     #   #     # # # #
### # # ### # # ### # # # ### # ###
#           #   # # # # #   #   ###
#   #         #   #   #     # # ###
# # ### ######### # # # ### # # # #
# # #   #           #   #         #
# # # ### ######### ##### ### ### #
# # # # #   #     #   #     # # # #
### # # ### # # ### # # # ### # ###
#            #   # # # # #   #   ##
#                        #        #
#   #         #   #   #     # # #E#
# # ### ######### # # # ### # # # #
# # #   #           #   #         #
# # # ### ######### ##### ### ### #
# # # # #   #     #   #     # # # #
### # # ### # # ### # # # ### # ###
#             #   # # # # #   #   #
###################################